15 10 4
##########
#        #
# #  ### #
# #  # # #
# #  # # #
# #  # # #
# #  # # #
#*#  # # #
# #  # # #
# #  # # #
# #  # # #
# #  # # #
# #  # # #
# #    # #
##########
